%%%%%%%%%
%.P.%%%%%
%...%%%%%
%%o%%%%%%
%      G%
%      G%
%...%...%
%.......%
%%o%%%%%%
%G      %
%       %
%...%%%%%
%...%%%%%
%%o%%%%%%
%     G %
%       %
%%%%%%%%%