%%%%%
%.P.%
%...%
%%o%%
%   %
%...%
%...%
%%o%%
%   %
%%%%%
%%%%%
%%%%%
