%%%%%
%%P%%
%%%%%
%%o%%
%   %
%%%%%
%%%%%
%%o%%
%   %
%%%%%
%%%%%
%%%%%
