%%%%%%%%%
%.P.%...%
%.......%
%%o%%%%%%
%   GGG %
%...%...%
%.......%
%%o%%%%%%
%     G %
%...%...%
%.......%
%%%%%%%%%
