%%%%%%%%%%%%%%%%%
%.P.%...%...%...%
%...............%
%%o%%%%%%%%%%%%%%
%       G       %
%...%...%%%%%%%%%
%.......%%%%%%%%%
%%o%%%%%%%%%%%%%%
%               %
%...%...%%%%%%%%%
%.......%%%%%%%%%
%%o%%%%%%%%%%%%%%
%          G    %
%...%...%%%%%%%%%
%.......%%%%%%%%%
%%o%%%%%%%%%%%%%%
%    G          %
%...%...%%%%%%%%%
%.......%%%%%%%%%
%%%%%%%%%%%%%%%%%
